2.Dedale
11111111111111111111111111111111111111111111111111111111111111111
11111111111111111111111000000000000111111111111111111110000011111
11111100000000011100000000000000000000000001111110000000000000111
11000000000000000000000001111110000000000000000000000000C00000111
110P0000000000010101010000000000000000000000000000000000000000111
1100001111110000000000000E000000000000000000000000000000000000011
11000001001000000000000000000000000000000000000000011111100000011
11000000110000010101010000000000000000000000001111111111000000001
11000001001000000000000000000110000000000000000001111100000000001
11100011111100111111100000000110000000000000000000000000000000001
11100000000000100000100000000000000C00000000000000000000000000001
11000000000000100000100000000000000000000000000000000000000000001
11010000000000000000000000000110000000001111100000000000000001111
10000000000000000000000000000110000000111111111111000000111111111
10000001000000001010101000000000000000000011110000000000000011111
10000111110000000101010000000000000000000000000000000000000000011
110011000000000000000000000001100000C0000000000000000000000000001
110000000000001110000000000001100000000000000000000000000000C0001
11000000000011111101101000000000000000000000000011111111110000001
11100000000001110000000000000000000000000000001111111111000000111
1111110000000000000000000C000000001110000000000000000011111111111
11110000000000000001100000000000111111000000000000000000000111111
11000000000000000011110000000000011100000000000000000000000000001
100000000000000000011100000000000000000000000000000000000C0000001
1000000000111000000000000000000000000C000000000000000000000000001
10000000011110000000000000000111000000000000001110000000000000001
10000000001110000000000000001111100000000000111111110000000000001
10000000000000000011000000000000000000000000001111000000000000011
10000000000000000001000000000000000000000000000000000000000000011
10000011000000000000000000110000000000000000000000000000000000011
10000111110000C00000000001110000000000000000000000000000C00000011
10000011110000000000000000000000000000111110000000000000000000111
11000000000000000111100000000000000011111111111110000000000000111
1111000000000000111111000000C000000000111111111000000000000000111
11111111111000000011000000000000000000000000000000000000000001111
11111111111100000000000000000000000000000000000000000001111111111
11111111111111111111111000000000000000000000000011111111111111111
11111111111111111111111111111111111111111111111111111111111111111
