##.la nouvelle map
1111111111111
1P010000000C1
10000000000C1
1000000000C01
10000000000C1
1000000000C01
10000000000C1
1000000000C01
10000000000C1
1000000000C01
10000000000C1
1000000000C01
10000000000C1
1000000000C01
10000000000C1
1000000000C01
10000000000C1
1000000000C01
10000000000C1
1000000000C01
10000000000C1
1000000000C01
10000000000C1
1000000000C01
10000000000C1
1000000000C01
10000000000C1
1000000000C01
10000000000C1
1000000000C01
10000000000C1
1000000000C01
10000000000C1
1000000000C01
10000000000C1
1000000000C01
1010011111001
100011E000001
1111111111111
