1.Salle d'entrainement
11111111111111111111111111111111111111111111111111111111111111111
1000C0000C0000000000000000000000000000000100000000000000000000001
10000000000000000000000000000000000000000000000000000000000000001
1000000000000000000000000010000000C000000000000000000000000000001
10000000000000000000000000100000000000000100000000000000000000001
10001111000000000000000000100011110101001100000000000000000000001
1000000000000C00000000000000000000000000000000C000000000000000001
10000000110000111111000000000000000000000000000000000000000000001
10000000100000000000000000000000000000000000000000000000000000001
100000001000000000000000C111111111111111000000000000P000000000001
10000000000001000001000001000000000000010000000000000000000000001
10000000000000000001000001000000000000010000000000000000000000001
10000000111000000111000011001000000010011000000000000000000000001
10000C00001000000100000000001000000010000000000000000000000000001
10000000001000000100000000001000E00010000000000000000000C00000001
10000000001100011100000000001000000010000000000000000000000000001
10000000000000000000000011001000000010011000000000000000000000001
10000000000000000C00000001000000000000010000000000000000000000001
10011000000000000000000001000000000000010000000000000000000000001
10011000000000000000000001111111111111110010010010000000000000001
10000000000000000000000000000000000000000000000010000000000000001
1000000000010001000100000000000000000000000000C010000000000000001
1000000C000000000000000000000000000000000000000010000000000000001
10000000000000000000000001001001000000111111111110000000000000001
10001000000000000000000000000000000000000000000000000000000000001
10000000000000000001000000000000000000000000000000000000000000001
10000000000100000000000001001001000000000000000000000000000000001
10011000000000000000000000000000000000000000000000000000000000001
100110000000C000000000000000000000000000000000000000000C000000001
10000000000100010001000001001001000000000000000000000000000000001
11111111111111111111111111111111111111111111111111111111111111111
