Court
11111111
10000001
1P0C00E1
10000001
11111111
